***************
*@..=.**..=...*
*.*.*=*.*=*=*.*
*..====&....=.*
*.*.*.*.*.*.*.*
*..=.....==...*
*.*.*.*.*.*.*=*
*.=.......=..=*
*.*=*.*.*=*.*.*
*=.&=......=.%*
*=*=*=*.*.*.*=*
*.=..=....==..*
***************
