***************
*@..=.**..=...*
*.*.*=*.*=*=*.*
*..====.....=.*
*.*.*.*.*.*.*.*
*..=.....==...*
*.*.*.*.*.*.*=*
*.=.......=..=*
*.*=*.*.*=*.*.*
*=..=......=..*
*=*=*=*.*.*.*=*
*.=..=....==..*
***************
